NO Texture/SUPPORT_3D.png
EA Texture/BRICK_2A.png
SO Texture/SUPPORT_7D.png
WE Texture/HEDGE_1A.png


F 255,255,255
C 45,255,255

1111111111111111111111111
1000000000010000000000001
1000000000010000000000001
1000000000010000003300001
1000000000010000000000001
1000011111100000000000001
1000000000000000000000001
1000000000000000000000001
1000000000000000000000001
1000000303005000000000001
1000000000000000000000001
1000000000000000000000001
1000000000000000000000001
1000000000000000000000001
1000000000001111111111111
1000000000000000000000001
1000000000000000000300001
1111111110000000000000001
1000000000000000000000001
1000000000000000000000501
10000000000000000N0000001
1111111111111111111111111