NO Texture/BRICK_2A.png
EA Texture/download.png
SO Texture/BRICK_2A.png
WE Texture/download.png


F 74,35,90
C 45,255,255

11111111111111111111111111111111111111111111111111
1000000000010000000000001
1000000000010000000000001
1000000000010000001100001
1000000000010000000000001
11Q1111111100000000000001
1000000000000000000000001
1000000000000000000000001
1000000000000000000000001
1000000101001000000000001
1000000000000000000000001
1000000000000000000000001
1000000000000000000000001
1000000000000000000000001
1000000000001111111111111
1000000000010000000000001
1000000000010000000100001
111111111QQ10000000000001
10000000000000000S0000001
1000000000000000000000101
1000000000000000000000001
1111111111111111111111111