NO Texture/firewatch.png
EA Texture/BRICK_2A.png
SO Texture/HEDGE_1A.png
WE Texture/SUPPORT_3D.png


F 74,35,90
C 45,255,255

11111111111111111111111111111111111111111111111111
1000000000010000000000001
1000000000010000000000001
1000000000010000001100001
1000000000010000000000001
1000011111100000000000001
1000000000000000000000001
1000000000000000000000001
1000000000000000000000001
1000000101001000000000001
1000000000000000000000001
10000000000QP000000000001
1000000000000000000000001
1000000000000000000000001
1000000000001111111111111
1000000000000000000000001
1000000000000000000100001
1111111110000000000000001
10000000000000000W0000001
1000000000000000000000501
1000000000000000000000001
1111111111111111111111111