NO Texture/download.png
EA Texture/BRICK_2A.png
SO Texture/download.png
WE Texture/BRICK_2A.png


F 74,35,90
C 45,255,255

  111111111111111111111111111
  1000000000010000000000001
  1000000000010000000000001
111 000000000010000001100001
1000000000010000000000001111
111QQ11111100000000000001
1000000000000000000000001
1000000000000000000000001
1000000000000000000000001
1000000101001000000000001
1000000000000000000000001
100000000000000000000000111
10000000  00000000000000001
100000000000000000000000111
1000000000001111111Q11111
1000000000001000000000001
100000000000Q000000100001
 11111111QQ11000000000001
100000000000000000E000001
1000000000000000000000101
1000000000000000000000001
1111111111111111111111111