NO Texture/SUPPORT_3D.png
EA Texture/SUPPORT_7D.png
SO Texture/SUPPORT_7D.png
WE Texture/HEDGE_1A.png


F 0,155,90
C 0,11,100

        1111111111111111111111111
        1000000000110000000000001
        1011000001110000000000001
        1001000000000000000000001
111111111011000001110000000000001
100000000011000001110111100111111
11110111111111011100000010001
11110111111111011101010010001
11000000110101011100000010001
100000000000000001100000000001
10000000000000001101010000001
11000001110101011111011110N0111
11110111 1110101 101111010001
11111111 1111111 111111111111